120 120 120 120 120 120 120 120 120 120 120 120 120 120 120 120 120 120 120 120 120 120
120 371 371 371 373 371 371 371 373 401 401 376 371 371 371 371 371 371 371 373 371 120
120 374 375 375 375 375 375 375 375 401 401 375 375 375 375 375 375 375 375 375 378 120
120 373 371 372 372 372 372 372 372 372 372 372 372 372 372 372 372 372 372 371 376 120
120 373 371 372 372 395 396 396 397 372 372 372 372 395 396 396 397 372 372 371 376 120
120 373 371 372 372 392 393 393 394 372 372 372 372 392 393 393 394 372 372 371 376 120
120 373 371 372 381 389 388 390 391 372 372 372 381 398 388 399 400 372 372 371 376 120
120 373 371 372 372 372 372 372 372 372 372 372 372 372 372 372 372 372 372 371 376 120
120 373 371 372 372 372 372 372 372 372 372 372 372 372 372 372 372 372 372 371 376 120
120 373 371 372 372 372 372 372 372 372 372 402 403 403 403 403 404 372 372 371 376 120
120 373 371 372 372 375 375 375 381 372 372 405 406 406 406 406 407 372 372 371 376 120
120 373 371 372 372 379 379 379 379 372 372 411 413 413 413 413 412 372 372 371 376 120
120 373 371 372 372 380 380 380 380 372 372 408 409 388 409 409 410 372 372 371 376 120
120 373 371 372 372 372 372 372 372 372 372 372 372 372 372 372 372 372 372 371 376 120
120 373 371 372 372 372 372 372 372 372 372 375 375 375 381 375 375 372 372 371 376 120
120 373 371 371 371 382 383 383 387 372 372 379 379 379 379 371 371 372 372 371 376 120
120 373 371 371 371 384 385 385 386 372 372 380 380 380 380 371 371 372 372 371 376 120
120 373 371 371 371 384 385 385 386 372 372 372 372 372 372 372 372 372 372 371 376 120
120 375 377 371 371 384 385 385 386 375 375 375 375 375 375 375 375 375 375 375 375 120
120 120 120 120 120 120 120 120 120 120 120 120 120 120 120 120 120 120 120 120 120 120