120 120 120 120 120 120 120 120 120 120 120 120 120 120 120 120 120 120 120 120 120 120 120 120 120 120 120 120 120 120 120 120 120 120 120 120
120 418 401 401 418 480 479 418 418 418 418 418 418 418 418 480 479 418 418 418 418 418 418 418 418 418 418 418 418 418 418 418 418 418 418 120
120 418 401 401 418 478 477 371 371 371 371 371 371 371 371 478 477 371 371 371 371 371 371 371 371 371 371 371 371 371 371 371 371 371 418 120
120 418 401 401 418 480 479 371 371 371 371 371 371 371 371 480 479 371 371 371 371 371 371 371 371 371 371 371 371 371 371 371 371 371 418 120
120 418 401 401 418 478 477 371 371 371 371 371 371 371 371 478 477 371 371 371 371 418 418 418 418 418 418 418 418 418 418 371 371 371 418 120
120 418 401 401 418 480 479 371 371 371 418 418 371 371 371 480 479 371 371 371 418 480 479 480 479 480 479 480 479 480 479 418 371 371 418 120
120 418 401 401 418 478 477 371 371 371 418 418 371 371 371 478 477 371 371 371 418 478 477 478 477 478 477 478 477 478 477 418 371 371 418 120
120 418 401 401 418 480 479 401 401 401 418 418 401 401 401 480 479 401 401 401 418 480 479 480 479 480 479 480 479 480 479 418 371 371 418 120
120 418 401 401 418 478 477 401 401 401 418 418 401 401 401 478 477 401 401 401 418 478 477 478 477 478 477 478 477 478 477 418 371 371 418 120
120 418 401 401 418 480 479 401 401 401 418 418 401 401 401 480 479 401 401 401 401 401 401 401 401 371 371 371 371 371 371 371 371 371 418 120
120 418 401 401 418 478 477 401 401 401 418 418 401 401 401 478 477 401 401 401 401 401 401 401 401 371 371 371 371 371 371 371 371 371 418 120
120 418 401 401 418 480 479 401 401 401 418 418 401 401 401 480 479 401 401 401 418 480 479 480 479 418 371 371 418 480 479 401 401 401 418 120
120 418 401 401 418 478 477 401 401 401 418 418 401 401 401 478 477 401 401 401 418 478 477 478 477 418 371 371 418 478 477 401 401 401 418 120
120 418 401 401 418 480 479 401 401 401 418 418 401 401 401 480 479 401 401 401 418 480 479 480 479 418 371 371 418 480 479 401 401 401 418 120
120 418 401 401 418 478 477 401 401 401 418 418 401 401 401 478 477 401 401 401 418 478 477 478 477 418 371 371 418 478 477 401 401 401 418 120
120 418 401 401 418 480 479 401 401 401 418 418 401 401 401 480 479 401 401 401 418 480 479 480 479 418 371 371 418 480 479 401 401 401 418 120
120 418 401 401 418 478 477 401 401 401 418 418 401 401 401 478 477 401 401 401 418 478 477 478 477 418 371 371 418 478 477 401 401 401 418 120
120 418 401 401 418 480 479 401 401 401 418 418 401 401 401 371 371 401 401 401 418 480 479 480 479 418 371 371 418 480 479 401 401 401 418 120
120 418 401 401 418 478 477 401 401 401 418 418 401 401 401 371 371 401 401 401 418 478 477 478 477 418 371 381 418 478 477 401 401 401 418 120
120 418 401 401 418 480 479 401 401 401 418 418 371 371 371 371 371 371 371 371 418 480 479 480 479 418 371 371 371 371 371 371 371 371 418 120
120 418 401 401 418 478 477 401 401 401 418 418 371 371 371 371 371 371 371 371 418 478 477 478 477 418 371 371 371 371 371 371 371 371 418 120
120 418 401 401 418 480 479 401 401 401 418 480 479 480 479 480 479 480 479 480 479 480 479 480 479 418 401 401 401 480 479 418 371 371 418 120
120 418 401 401 418 478 477 401 401 401 418 478 477 478 477 478 477 478 477 478 477 478 477 478 477 418 401 401 401 478 477 418 371 371 418 120
120 418 401 401 401 371 371 401 401 401 418 480 479 480 479 480 479 480 479 480 479 480 479 480 479 418 401 401 401 480 479 418 371 371 418 120
120 418 401 401 401 371 371 401 401 401 418 478 477 478 477 478 477 478 477 478 477 478 477 478 477 418 401 401 401 478 477 418 371 371 418 120
120 418 371 371 371 381 371 371 371 371 371 371 371 371 418 480 479 480 479 480 479 480 479 480 479 418 401 401 401 480 479 418 371 371 418 120
120 418 371 371 371 371 371 371 371 371 371 371 371 371 418 478 477 478 477 478 477 478 477 478 477 418 401 401 401 478 477 418 371 371 418 120
120 480 479 480 479 480 479 480 479 480 479 418 371 371 418 480 479 480 479 480 479 480 479 480 479 418 401 401 401 480 479 418 371 371 418 120
120 478 477 478 477 478 477 478 477 478 477 418 371 371 418 478 477 478 477 478 477 478 477 478 477 418 401 401 401 478 477 418 371 371 418 120
120 480 479 480 479 480 479 480 479 480 479 418 371 371 418 480 479 480 479 480 479 480 479 480 479 418 401 401 401 480 479 418 371 371 418 120
120 478 477 478 477 478 477 478 477 478 477 418 371 371 418 478 477 478 477 478 477 478 477 478 477 418 401 401 401 478 477 418 371 371 418 120
120 418 401 401 401 401 401 401 401 401 418 480 479 480 479 480 479 480 479 480 479 480 479 480 479 418 401 401 401 480 479 418 371 371 418 120
120 418 401 401 401 401 401 401 401 401 418 478 477 478 477 478 477 478 477 478 477 478 477 478 477 418 401 401 401 478 477 418 371 371 418 120
120 480 479 480 479 480 479 371 371 401 401 401 401 401 401 401 401 381 371 401 418 480 479 480 479 418 401 371 371 371 371 371 371 371 418 120
120 478 477 478 477 478 477 371 371 401 401 401 401 401 401 401 401 371 371 401 418 478 477 478 477 418 401 371 371 371 371 371 371 371 418 120
120 480 479 480 479 480 479 371 371 401 418 480 479 480 479 418 401 371 371 401 418 480 479 480 479 418 401 371 371 480 479 480 479 480 479 120
120 478 477 478 477 478 477 371 371 401 418 478 477 478 477 418 401 371 371 401 418 478 477 478 477 418 401 371 371 478 477 478 477 478 477 120
120 480 479 480 479 480 479 371 371 401 418 480 479 480 479 418 401 371 371 401 418 480 479 480 479 418 401 371 371 480 479 480 479 480 479 120
120 478 477 478 477 478 477 371 371 401 418 478 477 478 477 418 401 371 371 401 418 478 477 478 477 418 401 371 371 478 477 478 477 478 477 120
120 480 479 480 479 480 479 371 371 401 418 480 479 480 479 418 401 371 371 401 418 480 479 480 479 418 401 371 371 480 479 480 479 480 479 120
120 478 477 478 477 478 477 371 371 401 418 478 477 478 477 418 401 371 371 401 418 478 477 478 477 418 401 371 371 478 477 478 477 478 477 120
120 418 401 401 401 401 401 371 371 401 401 401 401 401 401 401 401 371 371 401 401 401 401 401 401 401 401 371 371 401 401 401 401 401 418 120
120 418 401 401 401 401 401 371 371 401 401 401 401 401 401 401 401 480 479 401 401 401 401 401 401 401 401 371 371 401 401 401 401 401 418 120
120 418 401 401 401 401 401 371 371 371 371 371 371 371 371 371 371 478 477 371 371 371 371 371 371 371 371 371 371 401 401 401 401 401 418 120
120 418 401 401 401 401 401 371 371 371 371 371 371 371 371 371 371 371 371 371 371 371 371 371 371 371 371 371 371 401 401 401 401 401 418 120
120 480 479 480 479 480 479 480 479 480 479 480 479 480 479 418 371 371 371 371 418 480 479 480 479 480 479 480 479 480 479 480 479 480 479 120
120 478 477 478 477 478 477 478 477 478 477 478 477 478 477 418 371 371 371 381 418 478 477 478 477 478 477 478 477 478 477 478 477 478 477 120
120 480 479 480 479 480 479 480 479 480 479 480 479 480 479 418 371 371 371 371 418 480 479 480 479 480 479 480 479 480 479 480 479 480 479 120
120 478 477 478 477 478 477 478 477 478 477 478 477 478 477 418 371 371 371 371 418 478 477 478 477 478 477 478 477 478 477 478 477 478 477 120
120 120 120 120 120 120 120 120 120 120 120 120 120 120 120 120 120 120 120 120 120 120 120 120 120 120 120 120 120 120 120 120 120 120 120 120