120 120 120 120 120 120 120 120 120 120 120 120 120 120 120 120 120 120 120 120 120 120
120 418 418 418 418 418 418 418 418 418 418 418 418 418 418 371 371 371 371 371 371 120
120 418 418 418 418 418 418 418 418 418 418 418 418 418 418 375 375 371 371 375 375 120
120 418 418 418 418 418 418 418 418 418 418 418 418 418 418 395 396 396 396 396 397 120
120 418 418 418 418 418 418 418 418 418 418 418 418 418 418 392 393 393 393 393 394 120
120 418 418 418 371 418 422 418 418 418 418 418 418 418 418 411 451 413 451 413 412 120
120 371 371 418 371 418 371 371 371 371 371 418 418 418 418 408 388 409 409 409 410 120
120 371 371 395 396 396 397 371 371 371 371 418 418 418 418 371 371 371 371 371 371 120
120 371 371 392 393 393 394 371 371 371 371 418 418 418 418 371 371 371 371 371 371 120
120 371 371 411 451 413 412 371 371 371 371 418 418 418 418 371 371 371 371 371 371 120
120 375 375 408 388 409 410 375 375 375 375 418 418 418 418 419 421 419 419 419 419 120
120 413 413 413 413 413 413 413 413 413 413 371 418 371 371 371 371 371 371 371 371 120
120 413 413 413 413 413 413 413 413 413 413 371 418 371 371 371 371 371 371 371 371 120
120 372 372 372 372 372 372 372 372 372 372 371 418 371 371 371 371 379 379 379 379 120
120 420 420 420 420 420 420 420 420 372 372 371 418 371 371 371 371 380 380 380 380 120
120 379 379 372 372 401 401 401 401 401 401 371 418 371 371 371 371 371 371 371 371 120
120 380 380 372 372 401 401 401 401 401 401 371 418 419 419 419 421 419 419 419 419 120
120 379 379 372 372 401 401 401 401 401 401 371 418 371 371 371 371 371 371 371 371 120
120 380 380 372 372 401 401 401 401 401 401 371 418 371 371 371 371 371 371 371 371 120
120 379 379 372 372 371 371 371 371 371 371 371 371 422 371 371 371 371 371 371 371 120
120 380 380 372 372 371 371 418 418 418 418 418 418 418 418 371 371 371 371 371 371 120
120 379 379 372 372 371 418 418 418 418 418 418 418 418 371 371 371 371 371 371 371 120
120 380 380 372 372 371 418 418 418 418 418 418 418 418 371 371 371 371 371 371 371 120
120 379 379 372 372 371 371 418 418 418 418 418 418 418 371 379 379 371 371 371 371 120
120 380 380 372 372 371 371 371 371 371 371 371 371 418 371 380 380 371 371 371 371 120
120 379 379 372 372 372 372 372 372 372 372 371 371 418 371 379 379 379 379 371 371 120
120 380 380 372 372 372 372 372 372 372 372 371 371 418 371 380 380 380 380 371 371 120
120 418 418 371 371 371 371 371 371 372 372 371 371 422 371 371 371 371 371 371 371 120
120 418 418 419 419 419 419 419 421 420 420 419 419 418 418 419 421 419 419 419 419 120
120 418 418 379 379 379 379 371 371 372 372 371 371 418 371 371 371 371 371 371 371 120
120 418 418 380 380 380 380 371 371 372 372 371 371 418 371 371 371 371 371 371 371 120
120 418 418 372 372 372 372 372 372 372 372 371 371 418 371 379 379 379 379 371 371 120
120 418 418 372 372 372 381 372 372 372 372 371 371 418 371 380 380 380 380 371 371 120
120 418 418 372 372 379 379 379 379 372 372 371 371 418 371 379 379 379 379 371 371 120
120 418 418 372 372 380 380 380 380 372 372 371 371 418 371 380 380 380 380 371 371 120
120 418 418 372 372 372 372 372 372 372 372 371 371 422 371 371 371 371 371 371 371 120
120 418 418 372 372 372 372 372 372 372 372 418 418 418 418 418 418 418 418 418 418 120
120 418 418 418 418 418 418 429 372 372 372 418 418 418 418 418 418 418 418 418 418 120
120 418 418 418 418 418 418 429 372 372 372 418 418 418 418 418 418 418 418 418 418 120
120 120 120 120 120 120 120 120 120 120 120 120 120 120 120 120 120 120 120 120 120 120