120 120 120 120 120 120 120 120 120 120
120 91 93 95 97 98 99 98 100 120
120 92 92 96 102 102 102 102 101 120
120 102 102 102 102 102 102 102 102 120
120 102 102 103 107 106 103 102 102 120
120 102 102 103 104 105 103 102 102 120
120 102 102 102 102 102 102 102 102 120
120 109 102 102 102 102 102 102 109 120
120 110 102 108 108 102 102 102 110 120
120 120 120 120 120 120 120 120 120 120