120 120 120 120 120 120 120 120 120 120 120 120 120 120 120 120 120 120 120 120 120 120
120 371 373 371 371 371 371 371 373 372 372 376 371 371 371 371 371 376 371 371 371 120
120 371 373 375 375 375 375 375 375 372 372 375 375 375 375 375 375 376 371 371 371 120
120 371 373 379 379 379 379 371 371 372 372 371 371 371 371 379 379 376 371 371 371 120
120 371 373 380 380 380 380 371 371 372 372 371 371 371 371 380 380 376 371 371 371 120
120 371 373 371 371 371 371 371 418 372 372 372 372 372 372 372 372 376 371 371 371 120
120 371 373 419 419 419 419 419 418 420 420 420 420 372 372 372 372 376 371 371 371 120
120 371 418 371 371 371 371 371 418 401 401 401 401 401 401 401 401 418 371 371 371 120
120 371 418 371 371 371 371 371 418 401 401 401 401 401 401 401 401 418 371 371 371 120
120 371 418 371 371 371 371 371 418 401 401 401 401 401 401 401 401 418 371 371 371 120
120 371 418 419 419 419 419 419 418 401 401 401 401 401 401 401 401 418 371 371 371 120
120 371 418 371 371 379 379 379 379 371 371 372 372 372 372 372 372 418 371 371 371 120
120 371 418 371 371 380 380 380 380 371 371 372 372 372 372 372 372 418 371 371 371 120
120 371 418 371 371 371 371 371 371 371 371 372 372 401 401 401 401 418 371 371 371 120
120 371 418 375 375 419 419 419 419 375 375 375 375 401 401 401 401 418 371 371 371 120
120 371 373 371 371 371 371 379 379 379 379 372 372 401 401 401 401 376 371 371 371 120
120 371 373 371 371 371 371 380 380 380 380 372 372 401 401 401 401 376 371 371 371 120
120 371 373 371 371 372 372 372 372 372 372 372 372 379 379 379 379 376 371 371 371 120
120 371 373 371 371 372 372 372 372 372 372 372 372 380 380 380 380 376 371 371 371 120
120 371 373 371 371 372 372 371 371 371 371 371 371 371 371 371 371 376 371 371 371 120
120 371 373 419 421 420 420 419 421 419 419 419 419 419 419 419 419 376 371 371 371 120
120 371 373 371 371 372 372 372 372 372 372 372 372 372 372 372 372 376 371 371 371 120
120 371 373 371 371 372 372 372 372 372 372 372 372 372 372 372 372 376 371 371 371 120
120 371 373 371 371 371 371 371 371 371 371 401 401 401 401 372 372 376 371 371 371 120
120 371 373 418 418 418 418 418 418 418 418 401 401 401 401 420 420 376 371 371 371 120
120 371 373 371 371 371 371 379 379 379 379 401 401 401 401 372 372 376 371 371 371 120
120 371 373 371 371 371 371 380 380 380 380 401 401 401 401 372 372 376 371 371 371 120
120 371 373 372 372 372 372 372 372 372 372 372 372 372 372 372 372 376 371 371 371 120
120 371 373 420 420 372 372 372 381 420 420 420 420 420 420 420 420 376 371 371 371 120
120 371 418 371 371 401 401 401 401 372 372 371 371 401 401 401 401 418 371 371 371 120
120 371 418 371 371 401 401 401 401 372 372 371 371 401 401 401 401 418 371 371 371 120
120 371 418 401 401 401 401 379 379 372 372 401 401 401 401 379 379 418 371 371 371 120
120 371 418 401 401 401 401 380 380 372 372 401 401 401 401 380 380 418 371 371 371 120
120 371 418 375 375 375 375 375 374 401 401 378 375 375 375 375 375 418 371 371 371 120
120 371 418 371 371 371 371 371 373 401 401 376 371 371 371 371 371 418 371 371 371 120
120 371 418 371 371 371 371 371 373 401 401 376 371 371 371 371 371 418 371 371 371 120
120 371 418 371 371 371 371 371 373 401 401 376 371 371 371 371 371 418 371 371 371 120
120 120 120 120 120 120 120 120 120 120 120 120 120 120 120 120 120 120 120 120 120 120