120 120 120 120 120 120 120 120 120 120 120 120 120 120 120 120 120 120 120 120 120 120 120 120 120 120 120 120 120 120 120 120 120 120 120 120 120 120 120 120 120 120
120 423 423 423 426 423 426 418 418 418 418 418 418 418 418 418 418 429 372 372 372 418 418 418 418 418 418 418 418 418 418 418 418 418 418 418 418 418 418 418 418 120
120 423 423 423 426 423 426 418 418 418 418 418 418 418 418 418 418 429 372 372 381 418 418 418 418 418 418 418 418 418 418 418 418 418 418 418 418 418 418 418 418 120
120 423 423 423 426 423 426 418 418 418 418 418 418 418 418 418 418 429 372 372 372 418 418 418 418 372 372 372 372 372 372 372 372 372 372 372 372 418 418 418 418 120
120 423 423 423 426 423 426 418 418 418 418 418 418 418 418 418 418 429 372 372 372 418 418 418 418 372 372 372 372 372 372 372 372 372 372 372 372 418 418 418 418 120
120 423 423 423 426 423 426 371 371 371 371 371 371 371 371 422 371 372 372 372 372 448 449 449 450 372 372 372 372 442 443 443 443 443 444 372 372 418 418 418 418 120
120 423 423 423 426 423 426 371 371 375 375 375 375 375 375 418 418 372 372 372 372 452 458 459 454 372 372 372 372 447 446 446 446 446 445 372 372 418 418 418 418 120
120 423 423 423 426 423 426 371 376 418 418 418 418 418 418 418 418 429 372 372 372 372 372 372 372 372 372 372 372 455 462 463 464 462 460 372 372 418 418 418 418 120
120 423 423 423 426 423 426 371 376 418 418 418 418 418 418 418 418 429 372 372 372 372 372 372 372 372 372 372 381 452 458 459 453 388 454 372 372 418 418 418 418 120
120 423 423 423 426 423 426 371 376 418 418 418 418 418 418 418 418 429 372 372 372 448 449 449 450 372 372 372 372 371 371 371 371 371 371 372 372 418 418 418 418 120
120 423 423 423 426 423 426 371 376 418 418 418 418 418 418 418 418 429 372 372 372 452 388 459 454 420 420 420 420 419 419 419 419 419 419 420 420 418 418 418 418 120
120 423 423 423 426 423 426 371 376 418 418 418 418 418 418 418 418 429 372 372 372 372 372 372 372 372 372 372 372 372 372 372 372 372 372 372 372 418 418 418 418 120
120 428 428 428 427 423 426 371 376 418 418 418 418 418 418 418 418 429 372 372 372 372 372 372 372 372 372 372 372 372 372 372 372 372 372 372 372 418 418 418 418 120
120 423 423 423 423 423 426 371 376 418 418 418 418 418 418 418 418 429 372 372 372 372 372 402 403 403 403 403 404 372 372 372 372 372 372 372 372 418 418 418 418 120
120 428 428 428 428 428 427 371 376 418 418 418 418 418 418 418 418 429 372 372 372 372 372 405 406 406 406 406 407 372 372 429 429 429 429 429 429 418 418 418 418 120
120 371 371 371 371 371 371 371 376 418 418 418 418 418 418 418 418 429 372 372 372 372 372 411 451 413 451 451 412 372 372 372 372 372 372 372 372 418 418 418 418 120
120 371 371 371 371 371 371 371 376 418 418 418 418 418 418 418 418 429 372 372 372 372 381 408 388 409 409 409 410 372 372 372 372 372 372 372 372 418 418 418 418 120
120 372 372 372 372 372 372 371 371 418 418 418 418 418 418 418 418 372 372 372 372 372 372 372 372 372 372 372 372 436 437 437 438 371 371 372 372 418 418 418 418 120
120 372 372 372 372 372 372 371 371 371 371 371 371 371 371 371 371 372 381 372 372 372 372 372 372 372 372 372 372 441 440 440 439 371 371 372 372 418 418 418 418 120
120 424 424 424 425 372 372 372 372 372 372 372 372 372 372 372 372 372 372 372 372 372 372 379 379 371 371 371 371 411 451 413 412 371 371 372 372 418 418 418 418 120
120 423 423 423 426 372 372 372 372 372 372 372 372 372 372 372 372 372 372 372 372 372 372 380 380 371 371 371 371 408 388 466 410 371 371 372 372 418 418 418 418 120
120 423 423 423 426 372 372 371 371 371 371 371 371 371 371 371 371 372 372 372 372 372 372 372 372 372 372 372 372 372 372 372 372 372 372 372 372 418 418 418 418 120
120 423 423 423 426 375 375 375 377 371 371 371 371 371 371 371 371 372 372 372 372 372 372 372 372 372 372 372 372 372 372 372 372 372 372 372 372 418 418 418 418 120
120 423 423 423 426 372 372 371 371 422 371 379 379 379 379 371 371 372 372 379 379 372 372 430 431 431 432 372 372 379 379 371 371 371 371 372 372 418 418 418 418 120
120 423 423 423 426 372 372 371 371 418 418 380 380 380 380 371 371 372 372 380 380 372 372 435 434 434 433 372 372 380 380 371 371 371 371 372 372 418 418 418 418 120
120 423 423 423 426 372 372 371 371 382 383 383 383 383 387 371 371 372 372 371 371 372 372 411 451 413 412 372 372 371 371 371 371 379 379 372 372 418 418 418 418 120
120 423 423 423 426 372 372 371 371 384 385 385 385 385 386 371 371 372 372 371 371 372 372 408 388 465 410 372 372 371 371 371 371 380 380 372 372 418 418 418 418 120
120 423 423 423 426 372 372 371 371 384 385 385 385 385 386 371 371 372 372 371 371 372 372 372 372 372 372 372 372 372 372 372 372 372 372 372 372 418 418 418 418 120
120 423 423 423 426 420 420 419 419 384 385 385 385 385 386 419 421 420 420 419 421 420 420 420 420 420 420 420 420 420 420 420 420 420 420 420 420 418 418 418 418 120
120 423 423 423 426 372 372 379 379 371 371 371 371 371 371 371 371 372 372 371 371 371 371 371 371 379 379 379 379 372 372 379 379 379 379 372 372 418 418 418 418 120
120 423 423 423 426 372 372 380 380 371 371 371 371 371 371 371 371 372 372 371 371 371 371 371 371 380 380 380 380 372 372 380 380 380 380 372 372 418 418 418 418 120
120 423 423 423 426 372 372 372 372 372 372 372 372 372 372 372 372 372 372 372 372 372 372 372 372 372 372 372 372 372 372 372 372 372 372 372 372 418 418 418 418 120
120 428 428 428 427 429 429 429 429 429 429 429 429 429 429 429 429 429 429 429 429 429 429 429 429 429 429 429 429 372 372 429 429 429 429 429 429 418 418 418 418 120
120 371 371 371 371 371 371 371 371 371 371 371 371 371 371 371 371 371 371 371 371 371 373 371 371 371 371 371 373 372 372 376 371 371 371 371 371 376 371 371 371 120
120 371 371 371 371 371 371 371 371 371 371 371 371 371 371 371 371 371 371 371 371 371 373 371 371 371 371 371 373 372 372 376 371 371 371 371 371 376 371 371 371 120
120 371 371 371 371 371 371 371 371 371 371 371 371 371 371 371 371 371 371 371 371 371 373 371 371 371 371 371 373 372 372 376 371 371 371 371 371 376 371 371 371 120
120 371 371 371 371 371 371 371 371 371 371 371 371 371 371 371 371 371 371 371 371 371 373 371 371 371 371 371 373 372 372 376 371 371 371 371 371 376 371 371 371 120
120 120 120 120 120 120 120 120 120 120 120 120 120 120 120 120 120 120 120 120 120 120 120 120 120 120 120 120 120 120 120 120 120 120 120 120 120 120 120 120 120 120