120 120 120 120 120 120 120 120 120 120 120 120 120 120
120 29 29 33 31 29 29 37 40 37 40 37 40 120
120 28 28 34 32 28 28 38 39 38 39 38 39 120
120 30 30 35 30 30 30 30 30 30 30 30 30 120
120 30 30 34 30 30 30 30 30 30 30 30 30 120
120 31 31 36 30 37 40 37 40 37 40 30 41 120
120 32 32 30 30 38 39 38 39 38 39 30 42 120
120 30 30 30 30 30 30 30 30 30 30 30 41 120
120 30 30 1 1 30 30 30 30 30 30 30 42 120
120 120 120 120 120 120 120 120 120 120 120 120 120 120