120 120 120 120 120 120 120 120 120 120
120 91 137 62 53 139 53 53 54 120
120 136 138 63 64 65 65 65 65 120
120 65 65 65 65 65 65 65 65 120
120 65 65 52 56 57 52 65 65 120
120 65 65 52 59 58 52 65 65 120
120 65 65 65 60 61 65 65 65 120
120 65 65 65 65 65 65 65 65 120
120 65 65 66 66 65 65 65 65 120
120 120 120 120 120 120 120 120 120 120
