120 120 120 120 120 120 120 120 120 120
120 91 91 53 53 53 139 53 91 120
120 75 75 468 468 468 468 468 75 120
120 468 468 468 468 468 468 468 468 120
120 468 468 476 56 57 476 468 468 120
120 468 468 476 475 471 476 468 468 120
120 468 468 468 468 468 468 468 468 120
120 109 468 468 468 468 468 468 109 120
120 474 468 108 108 468 468 468 474 120
120 120 120 120 120 120 120 120 120 120