120 120 120 120 120 120 120 120 120 120
120 67 68 67 469 470 67 67 91 120
120 468 468 468 468 468 468 468 75 120
120 468 468 468 468 468 468 468 468 120
120 468 468 468 473 57 468 468 468 120
120 468 468 468 472 471 468 468 468 120
120 468 468 468 468 468 468 468 468 120
120 109 468 468 468 468 468 468 109 120
120 474 468 108 108 468 468 468 474 120
120 120 120 120 120 120 120 120 120 120