120 120 120 120 120 120 120 120 120 120 120 120
120 12 14 15 4 4 5 4 4 4 21 120
120 11 13 16 3 3 6 3 3 3 19 120
120 8 8 9 8 10 7 0 0 0 3 120
120 3 3 3 3 3 3 0 0 0 0 120
120 0 0 0 0 0 0 0 0 0 0 120
120 0 0 0 0 0 0 0 17 17 0 120
120 0 0 0 0 0 0 0 0 0 0 120
120 2 0 0 1 1 0 0 17 17 0 120
120 120 120 120 120 120 120 120 120 120 120 120