120 120 120 120 120 120 120 120 120 120 120 120
120 67 67 69 68 416 416 74 74 74 74 120
120 76 79 90 90 90 90 75 75 75 75 120
120 77 78 90 90 90 90 90 90 90 90 120
120 90 90 90 90 90 90 81 82 83 84 120
120 90 90 90 90 90 90 77 80 78 90 120
120 90 90 90 90 90 90 90 90 90 90 120
120 74 74 74 74 90 90 74 74 74 74 120
120 75 75 75 75 90 90 75 75 75 75 120
120 90 90 90 90 90 90 90 90 90 90 120
120 90 90 90 90 90 90 90 90 90 90 120
120 90 90 90 90 90 90 90 90 90 90 120
120 90 90 90 90 89 89 90 90 90 90 120
120 120 120 120 120 120 120 120 120 120 120 120