120 120 120 120 120 120 120 120 120 120
120 140 53 53 53 91 137 53 366 120
120 141 65 414 415 136 138 65 65 120
120 65 65 60 61 65 65 65 65 120
120 65 65 65 65 65 65 65 65 120
120 65 65 65 367 65 65 65 65 120
120 65 65 65 368 65 65 65 65 120
120 369 65 65 65 65 65 65 65 120
120 370 65 65 65 65 65 65 65 120
120 120 120 120 120 120 120 120 120 120