t t t t t t t t t e e t t t t t t t t t t t
t f t f f f f f t f f t f f f f f t f f f t
t f t t t t t t t f f t t t t t t t f f f t
t f t f f f f f f f f f f f f f f t f f f t
t f t f f f f f f f f f f f f f f t f f f t
t f t f f f f f t f f f f f f f f t f f f t
t f t l l l l l t l l l l f f f f t f f f t
t f t f f f f f t b b b b b b b b t f f f t
t f t f f f f f t b b b b b b b b t f f f t
t f t f f f f f t b b b b b b b b t f f f t
t f t l l l l l t b b b b b b b b t f f f t
t f t f f f f f f f f f f f f f f t f f f t
t f t f f f f f f f f f f f f f f t f f f t
t f t f f f f f f f f f f b b b b t f f f t
t f t t t l l l l t t t t b b b b t f f f t
t f t f f f f f f f f f f b b b b t f f f t
t f t f f f f f f f f f f b b b b t f f f t
t f t f f f f f f f f f f f f f f t f f f t
t f t f f f f f f f f f f f f f f t f f f t
t f t f f f f f f f f f f f f f f t f f f t
t f t l f l l l f l l l l l l l l t f f f t
t f t f f f f f f f f f f f f f f t f f f t
t f t f f f f f f f f f f f f f f t f f f t
t f t f f f f f f f f b b b b f f t f f f t
t f t t t t t t t t t b b b b l l t f f f t
t f t f f f f f f f f b b b b f f t f f f t
t f t f f f f f f f f b b b b f f t f f f t
t f t f f f f f f f f f f f f f f t f f f t
t f t l l f f f d:11 l l l l l l l l t f f f t
t f t f f f f f f f f f f f f f f t f f f t
t f t f f f f f f f f f f f f f f t f f f t
t f t f f b b b b f f f f b b b b t f f f t
t f t b b b b f f f f b b b b f f t f f f t
t f t t t t t t t b b t t t t t t t f f f t
t f t f f f f f t b b t f f f f f t f f f t
t f t f f f f f t b b t f f f f f t f f f t
t f t f f f f f t b b t f f f f f t f f f t
t f t f f f f f t e e t f f f f f t f f f t