t t e e t t t t t t t t t t t t t t t t t t t t t t t t t t t t t t t t
t t f f t t t t t t t t t t t t t t t t t t t t t t t t t t t t t t t t
t t f f t t t f f f f f f f f t t f f f f f f f f f f f f f f f f f t t
t t f f t t t f f f f f f f f t t f f f f f f f f f f f f f f f f f t t
t t f f t t t f f f f f f f f t t f f f f t t t t t t t t t t f f f t t
t t b b t t t b b b t t b b b t t b b b t t t t t t t t t t t t f f t t
t t b b t t t b b b t t b b b t t b b b t t t t t t t t t t t t f f t t
t t b b t t t b b b t t b b b t t b b b t t t t t t t t t t t t f f t t
t t b b t t t b b b t t b b b t t b b b t t t t t t t t t t t t f f t t
t t b b t t t b b b t t b b b t t b b b b b b b b f f f f f f f f f t t
t t b b t t t b b b t t b b b t t b b b b b b b b f f f f f f f f f t t
t t b b t t t b b b t t b b b t t b b b t t t t t t f f t t t b b b t t
t t b b t t t b b b t t b b b t t b b b t t t t t t f f t t t b b b t t
t t b b t t t b b b t t b b b t t b b b t t t t t t f f t t t b b b t t
t t b b t t t b b b t t b b b t t b b b t t t t t t f f t t t b b b t t
t t b b t t t b b b t t b b b t t b b b t t t t t t f f t t t b b b t t
t t b b t t t b b b t t b b b t t b b b t t t t t t f f t t t b b b t t
t t b b t t t b b b t t b b b f f b b b t t t t t t f f t t t b b b t t
t t b b t t t b b b t t b b b f f b b b t t t t t t f t t t t b b b t t
t t b b t t t b b b t t f f f f f f f f t t t t t t f f f f f f f f t t
t t b b t t t b b b t t f f f f f f f f t t t t t t f f f f f f f f t t
t t b b t t t b b b t t t t t t t t t t t t t t t t b b b t t t f f t t
t t b b t t t b b b t t t t t t t t t t t t t t t t b b b t t t f f t t
t t b b b f f b b b t t t t t t t t t t t t t t t t b b b t t t f f t t
t t b b b f f b b b t t t t t t t t t t t t t t t t b b b t t t f f t t
t t f f f t f f f f f f f f t t t t t t t t t t t t b b b t t t f f t t
t t f f f f f f f f f f f f t t t t t t t t t t t t b b b t t t f f t t
t t t t t t t t t t t t f f t t t t t t t t t t t t b b b t t t f f t t
t t t t t t t t t t t t f f t t t t t t t t t t t t b b b t t t f f t t
t t t t t t t t t t t t f f t t t t t t t t t t t t b b b t t t f f t t
t t t t t t t t t t t t f f t t t t t t t t t t t t b b b t t t f f t t
t t b b b b b b b b t t t t t t t t t t t t t t t t b b b t t t f f t t
t t b b b b b b b b t t t t t t t t t t t t t t t t b b b t t t f f t t
t t t t t t t f f b b b b b b b b t f b t t t t t t b f f f f f f f t t
t t t t t t t f f b b b b b b b b f f b t t t t t t b f f f f f f f t t
t t t t t t t f f b t t t t t t b f f b t t t t t t b f f t t t t t t t
t t t t t t t f f b t t t t t t b f f b t t t t t t b f f t t t t t t t
t t t t t t t f f b t t t t t t b f f b t t t t t t b f f t t t t t t t
t t t t t t t f f b t t t t t t b f f b t t t t t t b f f t t t t t t t
t t t t t t t f f b t t t t t t b f f b t t t t t t b f f t t t t t t t
t t t t t t t f f b t t t t t t b f f b t t t t t t b f f t t t t t t t
t t b b b b b f f b b b b b b b b f f b b b b b b t b f f b b b b b t t
t t b b b b b f f b b b b b b b b t t b b b b b b b b f f b b b b b t t
t t b b b b b f f f f f f f f f f t t f f f f f f f f f f b b b b b t t
t t b b b b b f f f f f f f f f f f f f f f f f f f f f f b b b b b t t
t t t t t t t t t t t t t t t t f f f f t t t t t t t t t t t t t t t t
t t t t t t t t t t t t t t t t f f f t t t t t t t t t t t t t t t t t
t t t t t t t t t t t t t t t t f f f f t t t t t t t t t t t t t t t t
t t t t t t t t t t t t t t t t f f f f t t t t t t t t t t t t t t t t
t t t t t t t t t t t t t t t t e e e e t t t t t t t t t t t t t t t t