t t t t t t t t t t
t t t t t t t t e t
t d:3 d:3 d:4 d:5 f f f f t
t f f f f f f f f t
t f f f t t f f f t
t f f f t t f f f t
t f f f f f f f f t
t f f f f f f f f t
t f f f f f f f f t
t t t e e t t t t t