t f f f t f f f t e e t f f f f f f f t f t
t f f f t f f f t b b t f f f f f f f t f t
t t t t t t t t t b b t t t t t t t t t t t
t t f f f f f f f f f f f f f f f f f f t t
t t f f f t t t t f f f f t t t t f f f t t
t t f f f t t t t f f f f t t t t f f f t t
t t f f d:1 t e t t f f f d:9 t e t t f f f t t
t t f f f f f f f f f f f f f f f f f f t t
t t f f f f f f f f f f f f f f f f f f t t
t t f f f f f f f f f t t t t t t f f f t t
t t f f f t t t d:8 f f t t t t t t f f f t t
t t f f f f f f f f f t t t t t t f f f t t
t t f f f f f f f f f t t e t t t f f f t t
t t f f f f f f f f f f f f f f f f f f t t
t t f f f f f f f f f t t t d:10 t t f f f t t
t t f f f t t t t f f f f f f f f f f f t t
t t f f f t t t t f f f f f f f f f f f t t
t t f f f t t t t f f f f f f f f f f f t t
t t t f f t t t t t t t t t t t t t t t t t
t t t f f t t t t t t t t t t t t t t t t t