t t t t t t t t t t t t
t t t t t t t t t t t t
t t t f f f f t t t t t
t f f f f f f f f f f t
t f f f f f f t t t d:5 t
t f f f f f f f f f f t
t f f f f f f f f f f t
t t t t t f f t t t t t
t t t t t f f t t t t t
t f f f f f f f f f f t
t f f f f f f f f f f t
t f f f f f f f f f f t
t f f f f f f f f f f t
t t t t t e e t t t t t