t t t t t t t t t t t t t t t t t t t t t t
t t t t t t t t t t t t t t t f f f f f f t
t t t t t t t t t t t t t t t t t f f t t t
t t t t t t t t t t t t t t t t t t t t t t
t t t t t t t t t t t t t t t t t t t t t t
t t t t f t t t t t t t t t t t t t t t t t
t f f t f t f f f f f t t t t t f t t t t t
t f f t t t t f f f f t t t t f f f f f f t
t f f t t t t f f f f t t t t f f f f f f t
t f f t t t t f f f f t t t t f f f f f f t
t t t t f t t t t t t t t t t l f l l l l t
t f f f f f f f f f f f t f f f f f f f f t
t f f f f f f f f f f f t f f f f f f f f t
t f f f f f f f f f f f t f f f f f f f f t
t l l l l l l l l f f f t f f f f f f f f t
t f f f f b b b b b b f t f f f f f f f f t
t f f f f b b b b b b f t l l l f l l l l t
t f f f f b b b b b b f t f f f f f f f f t
t f f f f b b b b b b f t f f f f f f f f t
t f f f f f f f f f f f f t f f f f f f f t
t f f f f f f t t t t t t t t f f f f f f t
t f f f f f t t t t t t t t f f f f f f f t
t f f f f f t t t t t t t t f f f f f f f t
t f f f f f f t t t t t t t f f f f f f f t
t f f f f f f f f f f f f t f f f f f f f t
t f f f f f f f f f f f f t f f f f f f f t
t f f f f f f f f f f f f t f f f f f f f t
t t t f f f f f f f f f f t f f f f f f f t
t t t l l l l l f l l l l t t l f l l l l t
t t t f f f f f f f f f f t f f f f f f f t
t t t f f f f f f f f f f t f f f f f f f t
t t t f f f f f f f f f f t f f f f f f f t
t t t f f f t f f f f f f t f f f f f f f t
t t t f f f f f f f f f f t f f f f f f f t
t t t f f f f f f f f f f t f f f f f f f t
t t t f f f f f f f f f f t f f f f f f f t
t t t f f f f f f f f t t t t t t t t t t t
t t t t t t t t f f f t t t t t t t t t t t
t t t t t t t t f f f t t t t t t t t t t t
t t t t t t t t e e e t t t t t t t t t t t