t t t t t t t t t t t t t t t t t t e e e t t t t t t t t t t t t t t t t t t t t t
t t t t t t t t t t t t t t t t t t f f f t t t t t t t t t t t t t t t t t t t t t
t t t t t t t t t t t t t t t t t t f f d:12 t t t t t t t t t t t t t t t t t t t t t
t t t t t t t t t t t t t t t t t t f f f t t t t f f f f f f f f f f f f t t t t t
t t t t t t t t t t t t t t t t t t f f f t t t t f f f f f f f f f f f f t t t t t
t t t t t t t f f f f f f f f t f f f f f t t t t f f f f t t t t t t f f t t t t t
t t t t t t t f f t t t t t t t t f f f f t t t t f f f f t t t t t t f f t t t t t
t t t t t t t f t t t t t t t t t t f f f f f f f f f f f t t t t t t f f t t t t t
t t t t t t t f t t t t t t t t t t f f f f f f f f f f t t t t t t t f f t t t t t
t t t t t t t f t t t t t t t t t t f f f t t t t f f f f f f f f f f f f t t t t t
t t t t t t t f t t t t t t t t t t f f f t e t t l l l l l l l l l l l l t t t t t
t t t t t t t f t t t t t t t t t t f f f f f f f f f f f f f f f f f f f t t t t t
t t t t t t t f t t t t t t t t t t f f f f f f f f f f f f f f f f f f f t t t t t
t t t t t t t f t t t t t t t t t t f f f f f u u u u u u f f f f f f f f t t t t t
t t t t t t t f t t t t t t t t t t f f f f f t t t t t t f f t t t t t t t t t t t
e f f f f f f f t t t t t t t t t t f f f f f t t t t t t f f f f f f f f t t t t t
e f f f f f f f t t t t t t t t t t f f f f t t e t t t t f f f f f f f f t t t t t
e f f f f f f f f t t t t t t t t f f f f f f f f f f f f t t t t f f f f t t t t t
e f f f f f f f f f f f f f f f f f t f f f f f f f f f f t t t t f f f f t t t t t
t t t t t f f f f f f f f f f f f f f f f f f f f f f f f t t t t f f f f t t t t t
t t t t t f f f f f f f f f f f f f f f f f f f f f f f f t e t t f f f f t t t t t
t t t t t f f f f f f f f f f f f f f f f f f f f f f f f f f f f f f f f t t t t t
t t t t t t t t t f f f f f f f f f f f f f f f f f f f f f f f f f f f f t t t t t
t t t t t f f f f t f f f f f f f f f f f f f t t t t f f f f f f f f f f t t t t t
t t t t t f f f f t t f f f f f f f f f f f f t t t t f f f f f f f f f f t t t t t
t t t t t f f f f t t t t t t f f f f f f f f t t t t f f f f f f f f f f t t t t t
t t t t t f f f f t t t t t t f f f f f f f f t e t t f f f f f f f f f f t t t t t
t t t t t f f f f t t t t t t f f f f f f f f f f f f f f f f f f f f f f t t t t t
t t t t t l l l l t t t t t t l f l l l f l l l l l l l l l l l l l l l l t t t t t
t t t t t f f f f f f f f f f f f f f f f f f f f f f f f f f f f f f f f t t t t t
t t t t t f f f f f f f f f f f f f f f f f f f f f f f f f f f f f f f f t t t t t
t t t t t f f f f f f f f f f f f f f f f f f f f f f f f f f f f f f f f t t t t t
t t t t t t t t t t t t t t t t t t t t t t t t t t t t t f f t t t t t t t t t t t
t f f f f f f f f f f f f f f f f f f f f f t f f f f f t f f t f f f f f t f f f f
t f f f f f f f f f f f f f f f f f f f f f t f f f f f t f f t f f f f f t f f f f
t f f f f f f f f f f f f f f f f f f f f f t f f f f f t f f t f f f f f t f f f f
t f f f f f f f f f f f f f f f f f f f f f t f f f f f t f f t f f f f f t f f f f
t t t t t t t t t t t t t t t t t t t t t t t t t t t t t e e t t t t t t t t t t t